88888888888888888888888888888
99999999998888888888999999999
99999999999888888889999999999
99999999999988888899999999999
99999999999999889999999999999
99999999999999889999999999999
99999999999999889999999999999
99999999999999889999999999999
99999889998899889988999889999
99999889998899889988999889999
99999889998899889988999889999
88888888888888888888888888888
88888888888888888888888888888
99999889998899889988999889999
99999889998899889988999889999
99999889998899889988999889999
99999889998899889988999889999
99999999999999889999999999999
99999999999998888999999999999
99999999999988888899999999999
-
8,17,10,Policia,police2.png,police2.npc
9,10,4
9,5,4
9,23,4
9,18,4
8,10,7,Amy,amy.png,amy.npc
8,3,11,Pericia,prova2.png,pericia2.npc
8,11,1,Alfred,alfred.png,alfred.npc
8,13,1,Nicolas,cozinheiro.png,nicolas.npc
8,15,1,Edgar,empresa1.png,edgar.npc
8,17,1,Bob,empresa2.png,bob.npc
0,14,16
9,10,14
9,23,14
9,18,14
9,5,14